{
  "uuid": "e70b0dca-a3e9-4fc7-804a-06aecf4fad9d",
  "next_uuid": "7b4822d2-8b57-4383-8e6f-adf9ef4bf588",
  "name": "Level 6",
  "ballSpeed": 9,
  "bestTime": 0,
  "paddleSpeed": 15,
  "map": [
    1, 1, 1, 0, 1, 0, 0, 0, 1, 1, 1, 0, 1, 0, 0, 1, 0, 1, 0, 0, 
    1, 0, 1, 0, 1, 0, 0, 0, 1, 0, 1, 0, 1, 0, 0, 1, 0, 1, 0, 1,
    1, 1, 1, 0, 1, 0, 0, 0, 1, 1, 1, 0, 1, 1, 0, 1, 0, 1, 1, 0, 
    1, 0, 0, 0, 1, 0, 0, 0, 1, 0, 1, 0, 1, 0, 1, 1, 0, 1, 0, 0, 
    1, 0, 0, 0, 1, 0, 0, 0, 1, 0, 1, 0, 1, 0, 0, 1, 0, 1, 1, 0,
    1, 0, 0, 0, 1, 1, 1, 0, 1, 0, 1, 0, 1, 0, 0, 1, 0, 1, 0, 1
  ]
}
